2 13 31
###############################
#p * *2       *  ** * *      *#
# # # # #*# # #f# # # # # #*# #
#    * * s** **      *    **  #
# #*# # # # #1# #b#1# # # # #*#
#          *     **      *  **#
# # #*# # # # # #*#*#*#*# # # #
#   *        *   s *x* *      #
# # # # #*# # # # # # #*# #*# #
#   *b**         *1           #
# # # # # # # # # #*# # # # #*#
#  ** *   *    2              #
###############################