2 13 31
###############################
#p * *        *  ** * *      *#
# # # # #*# # #f# # # # # #*# #
#    * * s** **      *    **  #
# #*# # # # # # #b# # # # # #*#
#          *     **      *  **#
# # #*# # # # # #*#*#*#*# # # #
#   *        *   s *x* *      #
# # # # #*# # # # # # #*# #*# #
#   *b**         *            #
# # # # # # # # # #*# # # # #*#
#  ** *   *                   #
###############################