4 13 31
###############################
#p    * **    *   3   4       #
# # # #*# # # # # # # # # # # #
#      s* * *  *   * ** 3 *   #
# # # # # #*# # # # # # #*# # #
#*   * *    *b* *   **        #
#q# # # # # # # # # # # # #*# #
#    f     *        *    **  3#
# #*# # #*#*#*#*# # #1# # #*# #
#        * 4 *2*    *   *     #
#*# # # # # # # # # # #*# # #*#
#x*    * **    ** ***     1   #
###############################