5 13 31
###############################
#p * *3       f  ** * *      *#
# # # # #*# # #*# # # # # #*# #
#    * * *** **  5   *    **  #
# #*# # # # #4# #b#1# # # # #*#
#q         s     **      *  **#
# # #b# # # # # #*#*#*#*# # # #
#   *        *   * * * *   4  #
# # # # #*# # # # # # #*# #*# #
#   ****         *2           #
# # # # # # # # # #*# # # # #*#
#  ** *5  *    2              #
###############################